o   ***********
* *        * **
******* *  ** *
* * ** **     *
******    *   *
***    *     **
***  ***  * ***
* **      *   *
*     ** ** ***
* *  ** * *  **
*  **** **    *
**        *** *
**** ** *  *  *
********  ** **
********X******
