o   *****
***  ****
** *   **
** ** ***
***   ***
* * *  **
*  *** **
***     *
**   ** *
**X******
