o ************************************************
*           ***  ***** *   ***     ** *  * **  * *
*  *** ** ** *  ** * * *  **  * * *  ******  *** *
* **   ** ** *        **   * **** ** **** * ***  *
** ******  * ********    * **  **** **  ***** *  *
*      **           ***  *  * *   *     * ****** *
*  * ***** ********     *    * ** **  *    **  * *
*  **   *   ** * * ** ****** *  ****          ** *
**** * **  * * **   * **  *      ******* *    *  *
** ***  * **  ** ***** ***  **      ** *******  **
**    * *     * ** *  *****  *     *** ****   ****
**  ** ****       ***   **  ****  ***** *  **  ***
** ***  ** ****   **** * *  **  **  * *     *  ***
* ***  **  *    *       *** * *** **   ** **     *
* *   *  * * **     ***  *      *** *********   **
******    * *** *** *** ******* ***    *  **  ****
* **  *  *    *  ** ***    *  **     *  ***     **
** * * ** *                 **   ****   * ****  **
** *** ****** *** ********* *  ****      ****  ***
*************X************************************
