****o****
**     **
*      **
***** ***
***   ***
***    **
****** **
***     *
**   ****
**X******
